{
   
  "maze-1": [
    [1, 2, 1, 1, 1, 1, 1, 0, 1],
    [1, 0, 1, 0, 0, 0, 1, 0, 1],
    [1, 0, 1, 0, 1, 0, 1, 0, 1],
    [1, 0, 0, 0, 1, 1, 1, 0, 1],
    [1, 0, 1, 1, 1, 0, 0, 0, 1],
    [1, 0, 0, 0, 1, 1, 0, 1, 1],
    [1, 1, 0, 1, 1, 0, 0, 0, 1],
    [1, 0, 0, 0, 0, 0, 1, 0, 1],
    [1, 1, 1, 1, 1, 1, 1, 1, 1]
  ],
  
  "maze-2" : [
    [1, 1, 1, 1, 1, 1, 1, 1, 1, 1],
    [2, 0, 0, 0, 1, 0, 0, 0, 0, 1],
    [1, 0, 1, 0, 1, 0, 1, 0, 1, 1],
    [1, 0, 1, 0, 0, 0, 1, 0, 0, 1],
    [1, 0, 1, 1, 1, 1, 1, 1, 1, 1],
    [1, 0, 0, 0, 1, 0, 0, 0, 0, 1],
    [1, 1, 1, 0, 1, 0, 1, 1, 0, 1],
    [1, 0, 0, 0, 0, 0, 1, 0, 0, 0],
    [1, 1, 1, 1, 1, 1, 1, 1, 1, 1]
  ],

  "maze-3": [
    [1,1,1,1,1,1,1,1,1,1],
    [2,0,1,0,0,0,0,0,0,1],
    [1,0,1,1,1,0,1,1,0,1],
    [1,0,0,0,1,0,0,1,0,1],
    [1,1,1,0,1,1,0,1,0,1],
    [1,0,0,0,0,0,0,1,0,1],
    [1,0,1,1,1,1,1,1,0,1],
    [1,0,0,0,0,0,0,1,0,0],
    [1,1,1,1,1,1,1,1,1,1]
  ],

 "maze-4": [
    [1,1,1,1,1,1,1,1,1,1,1],
    [2,0,0,0,1,0,1,0,0,0,1],
    [1,0,1,0,1,0,1,0,1,0,1],
    [1,0,1,0,1,0,1,0,1,0,0],
    [1,0,1,0,1,0,1,0,1,0,1],
    [1,0,1,0,1,0,1,0,1,1,1],
    [1,0,1,0,1,0,0,0,0,0,1],
    [1,0,1,0,0,0,1,0,1,0,1],
    [1,0,1,0,1,1,1,0,1,0,1],
    [1,0,0,0,1,0,0,0,0,0,1],
    [1,1,1,1,1,1,1,1,1,1,1] 
  ],

  "maze-5": [
  
    [1,2,1,1,1,1,1,1,1,1,1],
    [1,0,1,0,0,0,0,0,0,0,1],
    [1,0,1,1,0,1,1,1,1,0,1],
    [1,0,0,0,0,0,0,0,1,0,1],
    [1,0,1,1,0,1,1,1,1,0,1],
    [1,0,1,0,0,0,0,0,1,0,1],
    [1,0,1,1,1,0,1,0,1,0,1],
    [1,0,1,0,1,0,1,0,1,0,1],
    [1,0,0,0,1,0,0,0,0,0,1],
    [1,1,1,1,1,1,1,1,1,0,1]
],

  "maze-6": [
    [1,1,1,1,1,1,1,1,1,1,1,1],
    [1,0,0,0,1,0,0,0,0,0,0,1],
    [1,1,1,0,1,0,1,1,0,1,0,1],
    [2,0,0,0,0,0,0,0,0,1,0,1],
    [1,0,1,1,1,0,1,0,1,1,1,1],
    [1,0,1,0,0,0,1,0,0,0,0,1],
    [1,0,1,0,1,0,1,0,1,0,0,1],
    [1,1,1,1,1,1,1,0,1,1,1,1]
  ],

  "maze-7": [
    [1,1,1,1,1,1,1,1,1,1,1,1,1,1,1],
    [2,0,0,0,0,0,0,0,1,0,0,0,0,0,1],
    [1,0,1,0,1,0,1,0,0,0,1,1,1,0,1],
    [1,0,1,1,1,0,1,1,0,1,1,0,0,0,1],
    [1,0,1,0,0,0,0,1,0,0,0,0,1,0,1],
    [1,0,1,0,1,1,1,1,0,1,1,0,1,0,1],
    [1,0,1,0,1,0,0,0,0,0,0,0,1,0,1],
    [1,0,1,0,1,0,1,1,1,0,1,0,1,0,1],
    [1,0,0,0,1,0,1,0,0,0,1,0,0,0,0],
    [1,1,1,1,1,1,1,1,1,1,1,1,1,1,1]
  ],

  "maze-8": [
    [1,1,1,1,1,1,1,1,1,1,1,1,1,1,1,1,1,1,1,1,1,1,1,1,1,1,1,1,1,1,1],
    [2,0,0,0,0,0,0,0,0,0,0,0,0,0,0,0,0,1,0,0,0,0,0,0,0,0,0,0,0,0,1],
    [1,0,1,1,1,0,1,1,1,1,1,1,1,1,1,1,1,1,0,1,1,1,1,1,1,0,1,1,1,0,1],
    [1,0,1,0,1,0,0,0,0,0,0,0,0,0,0,0,0,0,0,0,0,0,0,0,1,0,1,0,0,0,1],
    [1,0,1,0,1,1,1,1,1,1,1,1,0,1,1,1,1,1,1,1,1,1,1,0,1,0,1,0,1,1,1],
    [1,0,1,0,0,0,0,0,1,0,0,0,0,0,0,0,1,0,0,0,0,0,0,0,1,0,1,0,0,0,1],
    [1,0,1,0,1,1,1,0,0,0,1,1,1,1,1,0,1,0,1,1,1,0,1,1,1,0,1,1,1,0,1],
    [1,0,1,0,0,0,1,0,1,0,0,0,0,0,1,0,1,0,0,0,1,0,0,0,0,0,1,0,0,0,1],
    [1,0,1,0,1,0,1,0,1,1,1,1,1,0,1,0,1,1,1,0,1,1,1,0,1,1,1,0,1,0,1],
    [1,0,1,1,1,0,1,0,1,0,0,0,1,0,0,0,0,0,1,0,0,0,1,0,0,0,0,0,1,0,1],
    [1,0,1,0,0,0,1,0,1,0,1,1,1,1,1,1,1,1,1,1,1,0,1,0,1,1,1,1,1,0,1],
    [1,0,1,0,1,1,1,0,1,0,0,0,1,0,0,0,0,0,1,0,0,0,1,0,1,0,0,0,0,0,1],
    [1,0,1,0,1,0,1,0,1,1,1,0,1,0,1,1,1,1,1,0,1,1,1,0,1,0,1,0,1,1,1],
    [1,0,1,0,0,0,1,0,0,0,1,0,1,0,1,0,0,0,0,0,1,0,0,0,1,1,1,0,0,0,1],
    [1,0,1,1,1,0,1,0,1,0,1,0,1,0,1,1,1,0,1,1,1,0,1,1,1,0,0,0,1,0,1],
    [1,0,0,0,0,0,1,0,1,0,0,0,1,0,0,0,1,0,0,1,0,0,0,1,0,0,1,1,1,0,1],
    [1,1,1,1,1,1,1,0,1,1,1,1,1,1,1,0,1,0,1,1,0,1,1,1,1,1,0,0,0,0,1],
    [1,0,1,0,0,0,1,0,0,0,0,0,1,0,0,0,1,0,0,1,0,1,0,0,0,0,0,1,0,1,1],
    [1,0,1,0,1,0,1,1,1,1,1,0,1,0,1,1,1,1,0,1,0,1,0,1,1,1,1,1,0,0,0],
    [1,0,0,0,1,0,0,0,0,0,0,0,1,0,0,0,0,0,0,1,0,0,0,1,0,0,0,0,0,0,1],
    [1,1,1,1,1,1,1,1,1,1,1,1,1,1,1,1,1,1,1,1,1,1,1,1,1,1,1,1,1,1,1]
  ],

  "maze-9": [
    [1,1,1,1,0,1,1,1,1],
    [1,0,0,1,0,0,0,0,1],
    [1,1,0,1,1,0,1,0,1],
    [1,0,0,0,0,0,1,0,1],
    [2,0,1,0,1,0,1,0,1],
    [1,1,1,1,1,1,1,1,1]
  ]

}
