{
   
  "maze-1": [
    [1, 2, 1, 1, 1, 1, 1, 3, 1],
    [1, 0, 1, 0, 0, 0, 1, 0, 1],
    [1, 0, 1, 0, 1, 4, 1, 0, 1],
    [1, 0, 0, 0, 1, 1, 1, 0, 1],
    [1, 0, 1, 1, 1, 0, 0, 0, 1],
    [1, 0, 0, 0, 1, 1, 0, 1, 1],
    [1, 1, 0, 1, 1, 0, 0, 0, 1],
    [1, 0, 0, 0, 0, 0, 1, 0, 1],
    [1, 1, 1, 1, 1, 1, 1, 1, 1]
  ],
  
  "maze-2" : [
    [1, 1, 1, 1, 1, 1, 1, 1, 1, 1],
    [2, 0, 0, 0, 1, 0, 0, 0, 4, 1],
    [1, 0, 1, 0, 1, 0, 1, 0, 1, 1],
    [1, 0, 1, 0, 0, 0, 1, 0, 0, 1],
    [1, 0, 1, 1, 1, 1, 1, 1, 1, 1],
    [1, 0, 0, 0, 1, 0, 0, 0, 0, 1],
    [1, 1, 1, 0, 1, 0, 1, 1, 0, 1],
    [1, 4, 0, 0, 0, 0, 1, 0, 0, 3],
    [1, 1, 1, 1, 1, 1, 1, 1, 1, 1]
  ],

  "maze-3": [
    [1,1,1,1,1,1,1,1,1,1],
    [2,0,1,4,0,0,0,0,0,1],
    [1,0,1,1,1,0,1,1,0,1],
    [1,0,0,0,1,0,0,1,0,1],
    [1,1,1,0,1,1,0,1,0,1],
    [1,0,0,0,0,0,0,1,0,1],
    [1,0,1,1,1,1,1,1,0,1],
    [1,0,0,0,0,0,4,1,0,3],
    [1,1,1,1,1,1,1,1,1,1]
  ],

 "maze-4": [
    [1,1,1,1,1,1,1,1,1,1,1],
    [2,0,0,0,1,4,1,0,0,0,1],
    [1,0,1,0,1,0,1,0,1,0,1],
    [1,0,1,0,1,0,1,0,1,0,3],
    [1,0,1,0,1,0,1,0,1,0,1],
    [1,0,1,0,1,0,1,0,1,1,1],
    [1,0,1,0,1,0,0,0,0,0,1],
    [1,0,1,0,0,0,1,0,1,0,1],
    [1,0,1,0,1,1,1,0,1,0,1],
    [1,0,0,0,1,4,0,0,0,0,1],
    [1,1,1,1,1,1,1,1,1,1,1] 
  ],

  "maze-5": [
  
    [1,2,1,1,1,1,1,1,1,1,1],
    [1,0,1,4,0,0,0,0,0,0,1],
    [1,0,1,1,0,1,1,1,1,0,1],
    [1,0,0,0,0,0,0,0,1,0,1],
    [1,0,1,1,0,1,1,1,1,0,1],
    [1,0,1,0,0,0,0,0,1,0,1],
    [1,0,1,1,1,0,1,0,1,0,1],
    [1,0,1,4,1,0,1,0,1,0,1],
    [1,0,0,0,1,0,0,0,0,0,1],
    [1,1,1,1,1,1,1,1,1,3,1]
],

  "maze-6": [
    [1,1,1,1,1,1,1,1,1,1,1,1],
    [1,4,0,0,1,0,0,0,0,0,0,1],
    [1,1,1,0,1,0,1,1,0,1,0,1],
    [2,0,0,0,0,0,0,0,0,1,0,1],
    [1,0,1,1,1,0,1,0,1,1,1,1],
    [1,0,1,0,0,0,1,0,0,0,0,1],
    [1,4,1,0,1,0,1,0,1,0,4,1],
    [1,1,1,1,1,1,1,3,1,1,1,1]
  ],

  "maze-7": [
    [1,1,1,1,1,1,1,1,1,1,1,1,1,1,1],
    [2,0,0,0,0,0,0,0,1,0,0,0,0,0,1],
    [1,0,1,0,1,0,1,0,0,0,1,1,1,0,1],
    [1,0,1,1,1,0,1,1,0,1,1,0,0,0,1],
    [1,0,1,0,0,0,0,1,0,0,0,0,1,0,1],
    [1,0,1,0,1,1,1,1,0,1,1,0,1,0,1],
    [1,0,1,0,1,0,0,0,0,0,0,0,1,0,1],
    [1,0,1,0,1,0,1,1,1,0,1,0,1,0,1],
    [1,0,0,0,1,4,1,0,0,0,1,0,0,0,3],
    [1,1,1,1,1,1,1,1,1,1,1,1,1,1,1]
  ],

  "maze-8": [
    [1,1,1,1,1,1,1,1,1,1,1,1,1,1,1,1,1,1,1,1,1,1,1,1,1,1,1,1,1,1,1],
    [2,0,0,0,0,0,0,0,0,0,0,0,0,0,0,0,0,1,0,0,0,0,0,0,0,0,0,0,0,0,1],
    [1,0,1,1,1,0,1,1,1,1,1,1,1,1,1,1,1,1,0,1,1,1,1,1,1,0,1,1,1,0,1],
    [1,0,1,0,1,0,0,0,0,0,0,0,0,0,0,0,0,0,0,0,0,0,0,0,1,0,1,0,0,0,1],
    [1,0,1,0,1,1,1,1,1,1,1,1,0,1,1,1,1,1,1,1,1,1,1,0,1,0,1,0,1,1,1],
    [1,0,1,0,0,0,0,0,1,0,0,0,0,0,0,0,1,0,0,0,0,0,0,0,1,0,1,0,0,0,1],
    [1,0,1,0,1,1,1,0,0,0,1,1,1,1,1,0,1,0,1,1,1,0,1,1,1,0,1,1,1,0,1],
    [1,0,1,0,0,0,1,0,1,0,0,0,0,0,1,0,1,0,0,0,1,0,0,0,0,0,1,0,0,0,1],
    [1,0,1,0,1,0,1,0,1,1,1,1,1,0,1,0,1,1,1,0,1,1,1,0,1,1,1,0,1,0,1],
    [1,0,1,1,1,0,1,0,1,0,0,0,1,0,0,0,0,4,1,0,0,0,1,0,0,0,0,0,1,0,1],
    [1,0,1,0,0,0,1,0,1,0,1,1,1,1,1,1,1,1,1,1,1,0,1,0,1,1,1,1,1,0,1],
    [1,0,1,0,1,1,1,0,1,0,0,0,1,0,0,0,0,0,1,0,0,0,1,0,1,0,0,0,0,0,1],
    [1,0,1,0,1,0,1,0,1,1,1,0,1,0,1,1,1,1,1,0,1,1,1,0,1,0,1,0,1,1,1],
    [1,0,1,0,0,0,1,0,0,0,1,0,1,0,1,0,0,0,0,0,1,0,0,0,1,1,1,0,0,0,1],
    [1,0,1,1,1,0,1,0,1,0,1,0,1,0,1,1,1,0,1,1,1,0,1,1,1,0,0,0,1,0,1],
    [1,0,0,0,0,0,1,0,1,0,0,0,1,0,0,0,1,0,0,1,0,0,0,1,0,0,1,1,1,0,1],
    [1,1,1,1,1,1,1,0,1,1,1,1,1,1,1,0,1,0,1,1,0,1,1,1,1,1,0,0,0,0,1],
    [1,0,1,0,0,0,1,0,0,0,0,0,1,0,0,0,1,0,0,1,0,1,0,0,0,0,0,1,0,1,1],
    [1,0,1,0,1,0,1,1,1,1,1,0,1,0,1,1,1,1,0,1,0,1,0,1,1,1,1,1,0,0,3],
    [1,0,0,0,1,0,0,0,0,0,0,0,1,0,0,0,0,0,0,1,0,0,0,1,0,0,0,0,0,0,1],
    [1,1,1,1,1,1,1,1,1,1,1,1,1,1,1,1,1,1,1,1,1,1,1,1,1,1,1,1,1,1,1]
  ],

  "maze-9": [
    [1,1,1,1,3,1,1,1,1],
    [1,4,0,1,0,0,0,0,1],
    [1,1,0,1,1,0,1,0,1],
    [1,0,0,0,0,0,1,0,1],
    [2,0,1,4,1,0,1,4,1],
    [1,1,1,1,1,1,1,1,1]
  ],

  "maze-10": [
    [1,2,1,1,1,1,1,1],
    [1,0,0,0,1,0,4,1],
    [1,1,1,0,1,0,0,1],
    [1,0,0,0,0,0,1,1],
    [1,0,1,1,1,0,0,1],
    [3,0,1,0,0,0,0,1],
    [1,4,1,0,0,0,0,1],
    [1,1,1,1,1,1,1,1]
  ],

  "maze-11": [
    [1,2,1,1,1,1,1,1],
    [1,0,0,0,1,4,0,1],
    [1,1,0,1,1,0,0,1],
    [1,0,0,0,1,0,0,1],
    [1,0,1,0,1,0,0,3],
    [1,0,1,0,1,1,0,1],
    [1,4,0,0,0,0,0,1],
    [1,1,1,1,1,1,1,1]
  ],

  "maze-12": [
    [1,3,1,1,1,1,1,1],
    [1,0,1,0,0,0,0,1],
    [1,0,1,0,1,1,0,1],
    [1,0,0,0,1,4,0,1],
    [1,1,1,0,1,1,1,1],
    [1,4,0,0,0,0,0,1],
    [1,0,0,0,0,0,0,1],
    [1,1,1,1,1,1,2,1]
  ],

  "maze-13": [
  [1,3,1,1,1,1,1,1],
  [1,0,1,0,0,0,0,1],
  [1,0,1,0,1,0,4,1],
  [1,0,0,0,1,1,1,1],
  [1,1,1,0,1,0,4,1],
  [1,0,0,0,0,0,1,1],
  [1,0,0,0,0,0,0,1],
  [1,1,1,1,1,1,2,1]
],

  "maze-14": [
    [1,2,1,1,1,1,1,1,1,1],
    [1,0,0,0,1,0,0,0,4,1],
    [1,1,1,0,1,0,1,0,1,1],
    [1,4,0,0,1,0,1,0,0,1],
    [1,1,1,0,1,0,1,1,0,1],
    [1,0,1,0,0,0,1,0,0,1],
    [1,0,1,0,1,1,1,0,1,1],
    [1,0,0,0,1,0,0,0,0,1],
    [1,0,0,0,1,0,0,1,0,1],
    [1,1,1,1,1,1,1,1,3,1]
  ],

  "maze-15": [
    [1,2,1,1,1,1,1,1,1,1],
    [1,0,0,0,0,0,0,0,0,1],
    [1,0,1,1,1,1,0,0,0,1],
    [1,0,0,1,0,0,0,0,0,1],
    [1,0,0,1,0,0,0,1,0,1],
    [1,0,0,1,0,0,0,1,4,1],
    [1,1,0,1,1,1,0,1,1,1],
    [1,0,0,0,1,0,0,0,0,1],
    [1,4,0,0,1,0,0,0,0,1],
    [1,1,1,1,1,1,1,1,3,1]
  ],

  "maze-16": [
    [1,1,1,1,2,1,1,1,1,1],
    [1,0,0,0,0,0,0,0,4,1],
    [1,1,1,1,1,1,0,1,0,1],
    [1,4,0,0,0,1,0,1,0,1],
    [1,0,1,1,0,1,0,1,0,1],
    [1,0,1,0,0,1,0,1,0,1],
    [1,0,1,0,1,1,0,1,0,1],
    [1,0,0,0,0,0,0,1,0,1],
    [1,0,0,1,0,1,0,1,0,1],
    [1,1,1,1,3,1,1,1,1,1]
  ],

  "maze-17": [
    [1,1,1,1,1,1,1,1,1,1],
    [2,0,0,0,1,4,0,0,0,1],
    [1,1,1,0,1,0,1,1,0,1],
    [1,0,0,0,1,0,0,1,0,1],
    [1,0,1,1,1,1,0,1,0,1],
    [1,0,0,0,0,0,0,1,0,1],
    [1,1,1,0,1,1,1,1,0,1],
    [1,0,0,0,0,0,4,1,0,1],
    [1,0,0,0,0,0,0,1,0,1],
    [1,1,1,1,1,1,1,1,3,1]
  ],

  "maze-18": [
    [1,2,1,1,1,1,1,1,1,1,1,1],
    [1,0,0,0,0,0,0,0,0,0,4,1],
    [1,1,1,0,1,0,0,1,1,1,1,1],
    [1,0,0,0,1,0,0,0,0,0,0,1],
    [1,0,1,1,1,1,1,1,0,1,0,1],
    [1,4,0,0,0,0,0,1,0,1,0,1],
    [1,1,1,1,1,1,0,1,0,1,0,1],
    [1,0,1,0,1,0,0,1,0,1,0,1],
    [1,0,1,0,1,0,1,1,0,1,0,1],
    [1,0,0,0,0,0,0,0,0,1,0,1],
    [3,0,0,0,0,0,0,0,0,1,4,1],
    [1,1,1,1,1,1,1,1,1,1,1,1]
  ],

  "maze-19": [
    [1,2,1,1,1,1,1,1,1,1,1,1],
    [1,0,0,0,0,0,0,0,0,0,0,1],
    [1,0,1,1,1,1,1,1,1,0,0,1],
    [1,0,0,0,0,0,0,0,0,0,0,1],
    [1,0,1,1,1,1,1,0,1,1,0,1],
    [1,0,1,0,0,0,0,0,0,1,0,1],
    [1,0,1,0,1,1,1,1,0,1,0,1],
    [1,0,1,4,1,0,0,0,0,1,0,1],
    [1,1,1,1,1,0,1,1,1,1,0,1],
    [1,0,0,0,0,0,0,0,1,4,0,1],
    [1,0,0,0,0,0,0,4,1,0,0,1],
    [1,3,1,1,1,1,1,1,1,1,1,1]
  ],
  "maze-20" : [
    [1, 1, 1, 1, 1, 1, 1, 1, 1, 1, 1, 1, 1, 1, 1],
    [2, 0, 0, 0, 1, 0, 0, 0, 0, 0, 0, 0, 0, 0, 1],
    [1, 1, 1, 0, 1, 0, 1, 0, 1, 1, 1, 1, 1, 0, 1],
    [1, 0, 1, 0, 1, 0, 1, 0, 0, 0, 0, 0, 1, 0, 1],
    [1, 0, 1, 0, 1, 0, 1, 1, 1, 1, 1, 0, 1, 1, 1],
    [1, 0, 1, 0, 1, 0, 0, 0, 0, 0, 1, 0, 0, 0, 1],
    [1, 0, 1, 0, 1, 1, 1, 0, 1, 1, 1, 1, 1, 0, 1],
    [1, 0, 1, 0, 1, 0, 0, 0, 1, 0, 0, 0, 1, 0, 1],
    [1, 0, 1, 0, 1, 1, 1, 1, 1, 0, 1, 0, 1, 0, 1],
    [1, 0, 1, 0, 0, 0, 0, 0, 0, 0, 1, 0, 0, 0, 1],
    [1, 0, 1, 1, 1, 1, 1, 1, 1, 1, 1, 1, 1, 0, 1],
    [1, 0, 0, 0, 0, 0, 1, 0, 1, 0, 0, 0, 0, 0, 1],
    [1, 0, 1, 0, 1, 0, 1, 0, 1, 0, 1, 1, 1, 1, 1],
    [1, 0, 1, 0, 1, 0, 0, 0, 1, 0, 1, 0, 0, 0, 1],
    [1, 1, 1, 0, 1, 1, 1, 1, 1, 0, 1, 0, 1, 0, 1],
    [1, 0, 0, 0, 1, 0, 0, 0, 0, 0, 1, 0, 1, 0, 1],
    [1, 0, 1, 1, 1, 0, 1, 1, 1, 1, 1, 0, 1, 1, 1],
    [1, 0, 0, 0, 0, 0, 1, 0, 0, 0, 0, 0, 0, 0, 0],
    [1, 0, 1, 1, 1, 1, 1, 0, 1, 1, 1, 1, 1, 0, 1],
    [1, 0, 1, 0, 0, 0, 1, 0, 0, 0, 1, 0, 0, 0, 1],
    [1, 0, 1, 0, 1, 1, 1, 1, 1, 0, 1, 0, 1, 0, 1],
    [1, 0, 1, 0, 0, 0, 0, 0, 0, 0, 1, 0, 1, 0, 1],
    [1, 0, 1, 1, 1, 1, 1, 0, 1, 1, 1, 0, 1, 0, 1],
    [1, 0, 0, 0, 0, 0, 1, 0, 1, 0, 0, 0, 1, 0, 1],
    [1, 1, 1, 1, 1, 0, 1, 0, 1, 0, 1, 1, 1, 0, 1],
    [1, 0, 0, 0, 1, 0, 1, 0, 1, 0, 0, 0, 1, 0, 1],
    [1, 0, 1, 1, 1, 0, 1, 0, 1, 1, 1, 0, 1, 0, 1],
    [1, 0, 0, 0, 0, 0, 1, 0, 1, 0, 0, 0, 1, 0, 1],
    [1, 0, 1, 1, 1, 1, 1, 1, 1, 0, 1, 1, 1, 0, 1],
    [1, 0, 0, 0, 0, 0, 0, 0, 0, 0, 1, 0, 0, 0, 1],
    [1, 1, 1, 1, 1, 1, 1, 1, 1, 1, 1, 1, 1, 1, 1]
  ]

}
